R  800 600
SO ./texture/bluestone.xpm
NO ./texture/greystone.xpm
WE ./texture/wood.xpm
EA ./texture/eagle.xpm

S ./texture/barrel.xpm

C 176, 239, 235
F 17, 105, 20

        1111111111111111111111111
        1000000000110000000000001
        1111000001110000002000001
        1001000000000000000000001
111111111111000001110000000000001
110002000111111101110111111111111
1100000000000002010101001000001
11000E0210000000122000010000111
110000000100000001111111101111
112000000012000000001011010101
112220000111111111000000001111
1122222001110101 101111000001
1111111111111111 111111111111